XXXXXXXXXXXXXXXXXXXXXXXXXXXXXXXXXXXX
X   BBBBBBBBB     X    BBBBB GBBB  X
X B  B  WB    BBB X  B         B B X
X B BBXBBXB BXBBB    B XXXXXX  B B X
X B     BXXBB    BXXBBXXXX  X BB   X
X B BBXBXBBXBBBB   BBB  B X X  B B X
X X XG      B    XX   BBB X X BB B X
X X X X     B B   BBBB    X   BBBBXX
XXDXXXDBBBBBXXDXXBBBBXXXBBBXXDXXBBXX
X  B  X     XB B X        X B     XX
X     X    XXX BBX     G  B B BBB XX
X   XXXXX XX   BBX  BBBBB   B BB  XX
X     X   B  XX BXBB      B B BBBXXX
X BXB X  BB BBB BBXB BBBBBB    BBXXX
X B B X BBB  B  BBB  B         BBXXX
X   B X B XXXBBB BBB   B BBBB B  BBX
X B   XBB  BB  BPB  B B        BBBXX
XB B   B    B B BBBB   BBB  B B BXXX
X  XX B   B   B B  B B      B B   XX
XBBBB X B B B B B  B B BBB  X B   XX
XXXXDDBBXXXXXDXXBBBXXBBXXXXXXDXXXXXX
XBXXBBX   B B B    B X B    X B X  X
XBBXXXXXXXXXXXBX   B B B X    X BXXX 
X B BBB BB  B X    B X BXXB X B XB X
X B  BB  BB BX     B X BB   X B  B X
XBB  BBB BBBBB  XB   BBBBB  X B  B X
X  XXXBXX  D   BB  B  BBBBBBBBBBBBBX
XB XB BXXXXB  B B  X  B   B    X X X
X B B BB BBBBB X    B      G    X XX
X B B BB       B  B B  XBXBXB XX X X
X B XXBXBXXBXX X  B B    B B   XXX X
X B E  B     X X         B B      X
XXXXXXXXXXXXXXXXXXXXXXXXXXXXXXXXXXXX
